##################################
#                           X  O #
#              #   X       X     #
#         ##########    #        #
#   X   ###        #    #        #
#             P    #    ####     #
#############      #    #O       #
# O #     O #  O   # O  #    X   #
#   #  X    ######## ####        #
#   #       #       O#    X      #
#        X       ### #           #
#                               O#
##################################
